он выпустит бренд компании	он выпустит бренд компании
он покажет центр компании	он покажет центр компании
он покажет вопрос власти	он покажет вопрос власти
он покажет жизнь дочери	он покажет жизнь дочери
он покажет лидера компании	он покажет лидера компании
он читает приговор матери	он читает приговор матери
он вынудит сопротивление власти	он вынудит сопротивление власти
он напишет предложение дочери	он напишет предложение дочери
он напишет приговор власти	он напишет приговор власти
он напишет икону матери	он напишет икону матери
он напомнит данные полиции	он напомнит данные полиции
он напомнит совет матери	он напомнит совет матери
он напомнит информацию организации	он напомнит информацию организации
он напомнит вкус аудитории	он напомнит вкус аудитории
он напомнит рекомендацию администрации	он напомнит рекомендацию администрации
он скажет ответ редакции	он скажет ответ редакции
он упростит дело компании	он упростит дело компании
он упростит задачу власти	он упростит задачу власти
он даст разрешение авиакомпании	он даст разрешение авиакомпании
он даст письмо партии	он даст письмо партии
он представляет работу комиссии	он представляет работу комиссии
он представляет право организации	он представляет право организации
он оставит ответ власти	он оставит ответ власти
он оставит место дочери	он оставит место дочери
он оставит претензию организации	он оставит претензию организации
он предложит работу комиссии	он предложит работу комиссии
он предложит создание компании	он предложит создание компании
он предложит дом дочери	он предложит дом дочери
он предложит обучение молодёжи	он предложит обучение молодёжи
он оценит верность власти	он оценит верность власти
он несёт счёт компании	он несёт счёт компании
он ставит оценку организации	он ставит оценку организации
он предпочтёт песню смерти	он предпочтёт песню смерти
он докажет работу комиссии	он докажет работу комиссии
он докажет слово матери	он докажет слово матери
он докажет претензию компании	он докажет претензию компании
он докажет поддержку полиции	он докажет поддержку полиции
он пишет совет матери	он пишет совет матери
он найдёт место вещи	он найдёт место вещи
он укажет информацию организации	он укажет информацию организации
он представит управление корпорации	он представит управление корпорации
он представит директора компании	он представит директора компании
он представит компанию корпорации	он представит компанию корпорации
он представит письмо администрации	он представит письмо администрации
он напоминает задачу власти	он напоминает задачу власти
он принесёт внимание отрасли	он принесёт внимание отрасли
он принесёт помощь леди	он принесёт помощь леди
он предлагает совет оппозиции	он предлагает совет оппозиции
он предлагает выдачу части	он предлагает выдачу части
он предлагает помощь общественности	он предлагает помощь общественности